%%%%%%%%%%%%%%%%%%%%%
%    T      %     % %
%      %            %
% %   % %           %
%  %     % % %      %
%     %             %
%          %       %%
% %       %   % %   %
%% %   %   % %      %
%   %           %K  %
%%   % %            %
%       % %         %
%    %   %       %  %
% %   %           % S
%  %   %   % G % %  %
%     %   %       % %
%  %   %           %%
%   %   % %   %     %
%  %           % % %%
%   %   %           %
%%%%%%%%%%%%%%%%%%%%%
