%%%%%%%%%%%%%%%%%%%%%
S %     %         % %
%        % %        %
% %   % %     %     %
%  %     %       %  %
% %  %          %   %
%              % %  %
%                   %
%  % %           %  %
%     %   %         %
%        %     %    %
%     % %   %   %   %
%          %       %%
%     %   %  %    % %
%        %       %  %
% %         %T      %
%%   % %            %
%     % % %         %
%%       %         %%
%               %   %
%%%%%%%%%%%%%%%%%%%%%
