%%%%%%%%%%%%%%%%%%%S%
%     %   %         %
%%         % % % %  %
%     %   %         %
%                   %
% % %   %   %   %   %
%  %                %
%            T    % %
%          % %   % %%
%   % %       %     %
%  % % % %   %   G  %
% %                 %
%                %  %
%       %           %
%    %   %         %%
% %   %             %
%%   %     %   %    %
%             % %   %
%    %   % %       %%
%     %K    %       %
%%%%%%%%%%%%%%%%%%%%%