%%%%%%%%%%%%%%%%%%%%%
S %     %         % %
%        % %        %
% %   % %     %     %
%  %     %       %  %
% % %           %   %
%              % %  %
%                   %
%  % %           %  %
%     %   %         %
%        %     %    %
%     % %   %   %   %
%          %       %%
%     %   %   %   % %
%        %       %  %
% %         %T      %
%%   % %            %
%     %  % %        %
%%        %        %%
%               %   %
%%%%%%%%%%%%%%%%%%%%%