%%%%%%%%%%%%%
%T          %
%%     %    %
%   %   % % %
%% %   %   %%
%           %
%      %    %
%   %   %   %
%% %        %
S   %   % % %
%          %%
%     %     %
%%%%%%%%%%%%%
