%%%%%%%%%%%%%
%           %
%  %   %    %
%   %       %
%  % % %    %
%         % %
%  %     %  %
% % %       %
%    %     %%
%           %
%  % % % %  %
%     %     %
%%%%%S%%%%%%%
