%%%%%%%%%%%%%
S           %
%           %
%           %
%  %     %  %
%     %     %
%    % %    %
% % %     % %
%    %     %%
%           %
%%          %
%    T      %
%%%%%%%%%%%%%
