%%%S%%%%%%%%%
%       %   %
%           %
%   %       %
%      %    %
%           %
%           %
%           %
%  % %     %%
% %         %
%        %  %
% %         %
%%%%%%%%%%%%%
