%%%%%%%%%%%%%
%   %     % %
%           %
%    K  %   %
%%   % %    %
%       % % %
%% %   % G  %
%T      %   %
%%     %    %
%   % %     S
%  %        %
% %     %   %
%%%%%%%%%%%%%
