%%%%%%%%%%%%%
%       %   %
%           %
%      T  % %
%% %   % %  %
%     %     %
%  %        %
%       % % %
%        %  %
S     %     %
%           %
%       % % %
%%%%%%%%%%%%%
