%%%%%%%%%%%%%
%           %
%        %  %
% %         %
%  % % %    %
% %   %     %
%      %   %%
% %         %
%    %      %
%           %
%    % %    %
%           %
%%%%%%%S%%%%%
