%%%%%%%%%%%%%
%     %     %
%%       % %%
%   % %     %
%%          %
% % %     % %
%        %  %
%       %   %
%  % %      %
%        T% S
%%       %  %
%       %   %
%%%%%%%%%%%%%
