%%%%%%%%%%%%%
% % %       %
%    %     %%
% %   % %   %
%    %      %
% %       % %
%  % %     %%
%       % % S
%    %      %
%       %   %
%  %   %    %
%           %
%%%%%%%%%%%%%
