%%%%%%%%%S%%%
%           %
%    %   %  %
% %         %
%        %  %
%       %   %
%%   %   %  %
% %         %
%      %    %
% % %       %
%    %      %
%     %     %
%%%%%%%%%%%%%
