%%%%%%%S%%%%%
%           %
%      % %  %
%     %     %
%      %    %
%         % %
%           %
%   %       %
%           %
%           %
%           %
% %         %
%%%%%%%%%%%%%
