%%%%%%%%%%%%%%%%%
%       %     % %
%        %   %  %
%   % %     %   %
%    % %     %  %
%             % %
%  %       %    %
%   %       %   %
%G %            %
%   % % % %     %
%          %    %
S   % % %   % % %
%  % %   %      %
%               %
%%           %  %
%   %    K      %
%%%%%%%%%%%%%%%%%