%%%%%%%%%%%%%%%%%
%             %T%
%               %
%               %
%               %
%     %         %
%        G % % %%
% %  K  %       %
%  %            %
% %         %   %
%        %      %
%     %   %     %
%        % %   %%
%               %
%    %          %
% %   %         %
%%%S%%%%%%%%%%%%%