%%%%%%%%%%%%%%%%%
%   %  T    %   %
%%             %%
% %     % % %   %
%    %          %
%   %       %   %
%      % %      %
%       %     % %
%  % %     %   %%
%       % %     %
%%         %   %%
%   % % % %     %
%  %         %  %
%   %   % %   % %
%  %       % %  %
% %             %
%%%%%%%%%%%%%S%%%
