%%%%%%%%%%%%%%%%%
%               %
%      % %      %
% %             %
%  %            %
%   %K  %   %   %
%          G   %%
%         %   % %
%               %
%           %   %
%               %
%       %     % %
%%              %
%             % %
%               %
%           %   S
%%%%%%%%%%%%%%%%%