%%%%%%%%%%%%%%%%%
S             % %
%            %  %
% %   %       % %
%%     %        %
%         %     %
%  %            %
%               %
%%              %
%   %           %
%    %     %    %
%           %   %
%               %
%             % %
%  %            %
% %             %
%%%%%%%%%%%%%%%%%
