%%%%%%%%%%%%%%%%%
%               %
%      %        %
%   %     % %   %
%%              %
%     % % %     %
%  %            %
% %             %
%        % %    %
%   % %         %
%    %   %   %  %
%         %   % %
%  %   %   %    %
%     %   %T    %
%  %           %%
%     % %   %   %
%%%%%%%%%%%S%%%%%