%%%%%%%%%%%%%%%%%
%   %           %
%              %%
%             % %
%  %         %  %
%               %
%    %          %
%     %         %
%%       %      %
%       % %     S
%               %
%   % %   %     %
%          %    %
%   %           %
%  %       %    %
%  T  %         %
%%%%%%%%%%%%%%%%%