%%%%%%%%%%%%%%%%%
S     % %   %   %
%    %   %      %
%   %   %   %   %
%        %      %
%   %       %   %
%      %   %   %%
%               %
%%         %   %%
%       %   %   %
%          %   %%
%   %   % %     %
%    %   % %    %
% %       %  T  %
%%       %      %
%     %         %
%%%%%%%%%%%%%%%%%